###############################
#    ........                 #
# ############# ###############
#                             #
#   ###  ############         #
#     #  #                    #
#     #  ############         #
#                             #
###############################